11111111
10P0E001
10000001
10C01001
10000001
10001001
11111111