1111111111111111111111111111
1000010000000000000000000001
100000111000001E101100000011
11P0001100000011100000111001
101000000C0000001001C10010C1
1111111111111111111111111111
