1111111111111111111111111111
1000010000000100000000000001
101100111000000E001100000011
11P0001100000011100000111001
101000000C00000011001C100001
1111111111111111111111111111
